# #################################################
# #       #       #     #         #           #   #
# # ##### # # ### ##### # ### ### # ##### ##### # #
# #   # #   # # #     #     # #   # #   #       # #
# ### # ##### # ##### ####### ##### # # ######### #
#   #     #   #   #   #       #   # # #       #   #
### # ##### ### # # ### ####### # # # ######### ###
# # # #     #   # # #         # # # # #       #   #
# # # # ##### # ### ##### ### # # # # # ##### ### #
# # # # #     #   # #   # #   # #   # # #   # #   #
# # # # ##### ### # # # # # ### ##### # # # # # # #
#   # #     # #   #   # # #   #     #     # # # # #
# ######### # # # ##### # ### ##### ######### # ###
#           # # #   # # # #   #     #         #   #
############# # ### # # # # ### ##### ##### ##### #
#           # # #   # # # #     #     #     #     #
# ##### ### # # ### # # ### ##### # ######### #####
# #     #   # #   #   #   #       # #         #   #
### ##### ### ### ####### ######### # ######### # #
#   #   #   #   #   #   #       #   #           # #
# ##### ### ### ### # # ####### # ############### #
#   #     #   #   #   # #       # #             # #
### # ####### ######### # ####### ##### ####### # #
#   #       #     #     #   #   #   #   #       # #
# ######### ##### # ####### # ##### # ### ####### #
#     #       #     #     # #       # # # #       #
# ### # ##### # ##### # ### # ####### # # # ##### #
#   # # #     #   #   #     # # #     #   # # #   #
##### # # ####### # ######### # # ### ### # # # ###
#     # # #       #     #   # #   # #   # # #   # #
# ##### ### ########### ### # ### # ### ### # ### #
# #   #   # #         #   #     # #   #   # #   # #
# # # ### # ### # ####### ##### # ### ### # ### # #
#   # #   #   # # #     #     # #     #   # #     #
# ### # ##### # ### # ####### # ##### # # # ##### #
#   # #     # #     #       # # #     # # #     # #
### # ### # # ####### # ##### # ####### # ##### # #
# # # #   # #       # # #     #   #   # #     # # #
# # # # ### ####### ### # ####### # # # ####### ###
# # # # #     #         #     #     # # #     #   #
# # # # ####### ############# # ##### # # ### ### #
#   # # #           #       # # #   #   #   #   # #
# ### # # ########### ### # # # # # ### ### ### # #
# #   #       #       #   # # # # # #     # # # # #
# # ### ####### ####### ##### ### # # ##### # # # #
# # #   #     #   #     #     #   # #   #   # # # #
### # ### ### ### # ##### ##### ### ##### ### # # #
#   #   #   #   # # #   # #       #     # #   # # #
# ######### # ### # # # # ####### ##### # # ### # #
#           #     #   #           #       #       #
################################################# #
